11111111111111111111
1P11111xxxxxxxxxxXC1
100000001C11011111X1
111011111111X1xxx1x1
1xxxxxX0C1C1x1x1E1x1
1C101C1111xxx1x111x1
1110111xxxx111xxxxx1
111011101111C11111C1
1CXxxx1xxxxxxxxXC111
11111111111111111111