11111111111111
1C0111xxX1C1E1
110100x1000101
110101x1111101
1P0001x00000C1
11111111111111