type_2
11111111111111111111
1P1xxxxxxX0D000000C1
100011C11111X111D111
111011111111x1Xxxxx1
100C001111C1x1000001
1xxxxX1111xxx1xxxxX1
100H001xxxx111000001
1Xxxxx101111C11111D1
100K001xxxxxxxxXK1E1
11111111111111111111