11111111111111
1C0111xxX1K1E1
110100x1000101
110101x1111101
1P0001x0000DH1
11111111111111