11111111111111
1C01110001C1E1
11010001000101
11010101111101
1P000100000001
11111111111111